WWWWWWWWWWWWWWWWWWWWWWW
WFFFFFFFFIFFFFFFFFFFFFW
WFFFFFFFFIFFFFFFFFFFFFW
WFFFFFFFFIFFFFFFFFFFFFW
WFFFFFFFFIFFFFFFFFFFFFW
WIIIIIIIIIIIIIIIIIIIIIW
WFFFFFFFFFFWFFFFFFFFFFW
WIIIIIIIIIIIIIIIIIIIIIW
WFFFFFFFFIFFFFFFFFFFFFW
WFFFFFFFFIFFFFFFFFFFFFW
WFFFFFFFFIFFFFFFFFFFFFW
WWWWWWWWWWWWWWWWWWWWWWW
