WWWWWWWWWWWWWWWWWWWWWWW
WFFFFFFFFFFIFFFFFFFFFFW
WFFFFFFFFFFIFFFFFFFFFFW
WFFFFFFFFFFIFFFFFFFFFFW
WFFFFFFFFFFIFFFFFFFFFFW
WFFFFFFFFFFIFFFFFFFFFFW
WFFFFFFFFFFWFFFFFFFFFFW
WFFFFFFFFFFIFFFFFFFFFFW
WFFFFFFFFFFIFFFFFFFFFFW
WFFFFFFFFFFIFFFFFFFFFFW
WFFFFFFFFFFIFFFFFFFFFFW
WWWWWWWWWWWWWWWWWWWWWWW
