WWWWWWWWWWWWWWWWWWWWWWW
WFFFFFFFFIFFFFFFFFFFFFW
WFFFFFFFFIFFFFFFFFFFFFW
WEFFFFFFFIFFFFFFFFFFEFW
WFFFFFFFFIFFFFFFFFFFFFW
WIIIIIIIIEIIIIIIIIIIIIW
WFFFFFFFFFFWFFFFFFFFFFW
WIIIIIIIIEIIIIIIIIIIIIW
WEFFFFFFFIFFFFFFFFFFEFW
WFFFFFFFFIFFFFFFFFFFFFW
WFFFFFFFFIFFFFFFFFFFFFW
WWWWWWWWWWWWWWWWWWWWWWW
