WWWWWWWWWWWWWWWWWWWWWWW
WFFFFFFFFFFFFFFFFFFFFFW
WFFFFFFIIIIIIIIIFFFFFFW
WFFFFFFIFFFFFFFFFFFFFFW
WFFFFFFIFLFFFLFFFFFFFFW
WFFFFFFIIIIIIIIIFFFFFFW
WFFFFFFFFLFFFLFIFFFFFFW
WFFFFFFFFFFFFFFIFFFFFFW
WFFFFFFIIIIIIIIIFFFFFFW
WFFFFFFFFFFFFFFFFFFFFFW
WFFFFFFFFFFFFFFFFFFFFFW
WWWWWWWWWWWWWWWWWWWWWWW