WWWWWWWWWWWWWWWWWWWWWWW
WIIIIIIIIIIIIIIIIIIIIIW
WIIIIIIIIIIIIIIIIIIIIIW
WIIIIIIIIIIIIIIIIIIIIIW
WIIIIIIIIHHHHHIIIIIIIIW
WIIIIIIIIIIIIHIIIIIIIIW
WIIIIIIIIHIIIIIIIIIIIIW
WIIIIIIIIHHHHHIIIIIIIIW
WIIIIIIIIIIIIIIIIIIIIIW
WIIIIIIIIIIIIIIIIIIIIIW
WIIIIIIIIIIIIIIIIIIIIIW
WWWWWWWWWWWWWWWWWWWWWWW
