WWWWWWWWWWWWWWWWWWWWWWW
WHFFFFFFFIIIIIFFFFFFFHW
WFHFFFFFFIIIIIFFFFFFHFW
WFFHFFFFFIIIIIFFFFFHFFW
WFFFFFFFFIIIIIFFFFFFFFW
WFFFFFFFFIIIIIFFFFFFFFW
WFFFFFFFFIIIIIFFFFFFFFW
WFFFFFFFFIIIIIFFFFFFFFW
WFFHFFFFFIIIIIFFFFFHFFW
WFHFFFFFFIIIIIFFFFFFHFW
WHFFFFFFFIIIIIFFFFFFFHW
WWWWWWWWWWWWWWWWWWWWWWW
