WWWWWWWWWWWWWWWWWWWWWWW
WFFFFFFFFFFFFFFFFFFFFFW
WFFFFFHFFFFFFFFFFFFFFFW
WFFFFFHHFFFFFFFFFFFFFFW
WFFFFFHFHFFFFFFFFFFFFFW
WFFFFFHHHHFFFFFFFFFFFFW
WFFFFFHFFFHFFFFFFFFFFFW
WFFFFFHFFHFFFFFFFFFFFFW
WFFFFFHFHFFFFFFFFFFFFFW
WFFFFFHHFFFFFFFFFFFFFFW
WFFFFFFFFFFFFFFFFFFFFFW
WWWWWWWWWWWWWWWWWWWWWWW
