WWWWWWWWWWWWWWWWWWWWWWW
WFFFFFFFFFFFFFFFFFFFFFW
WFFFFFFIIIIIIIIIFFFFFFW
WFFFFFFIFFFFFFFFFFFFFFW
WFFFFFFIFSFFFSFFFFFFFFW
WFFFFFFIIIIIIIIIFFFFFFW
WFFFFFFFFSFFFSFIFFFFFFW
WFFFFFFFFFFFFFFIFFFFFFW
WFFFFFFIIIIIIIIIFFFFFFW
WFFFFFFFFFFFFFFFFFFFFFW
WFFFFFFFFFFFFFFFFFFFFFW
WWWWWWWWWWWWWWWWWWWWWWW