WWWWWWWWWWWWWWWWWWWWWWW
WFHFHFHFHFHFHFHFHFHFHFW
WHFHFHFHFHFHFHFHFHFHFHW
WFHFHFEFHFHFHFHEFHFHFW
WHFHFHFHFHFHFHFHFHFHFHW
WFHFHFHFHFHFHFHFHFHFHFW
WFFFFFFFFFFWFFFFFFFFFFW
WHFHFHFHFHFHFHFHFHFHFHW
WFHFHFEFHFHFHFHEFHFHFW
WHFHFHFHFHFHFHFHFHFHFHW
WFHFHFHFHFHFHFHFHFHFHFW
WWWWWWWWWWWWWWWWWWWWWWW
