WWWWWWWWWWWWWWWWWWWWWWW
WHHHHIIIIIIIIIIIIIHHHHW
WHHHHIIIIIIIIIIIIIHHHHW
WHHHHIIIIIIIIIIIIIHHHHW
WIIIIIIIIIIIIIIIIIIIIIW
WIIIIIIIIIIIIIIIIIIIIIW
WIIIIIIIIIIIIIIIIIIIIIW
WIIIIIIIIIIIIIIIIIIIIIW
WHHHHIIIIIIIIIIIIIHHHHW
WHHHHIIIIIIIIIIIIIHHHHW
WHHHHIIIIIIIIIIIIIHHHHW
WWWWWWWWWWWWWWWWWWWWWWW
