WWWWWWWWWWWWWWWWWWWWWWW
WFFFFFFFFFFFFFFFFFFFFFW
WFFFFFFFFFFFFFFFFFFFFFW
WFFFFFFFFFFFFFFFFFFFFFW
WFFFFFFFFFFWFFFFFFFFFFW
WFFFFFFFFFFWFFFFFFFFFFW
WFFFFFFWWWWWWWWWFFFFFFW
WFFFFFFFFFFWFFFFFFFFFFW
WFFFFFFFFFFWFFFFFFFFFFW
WFFFFFFFFFFFFFFFFFFFFFW
WFFFFFFFFFFFFFFFFFFFFFW
WWWWWWWWWWWWWWWWWWWWWWW
