WWWWWWWWWWWWWWWWWWWWWWW
WIIIIIIIIIIIIIIIIIIIIIW
WIIIIIIIIIIIIIIIIIIIIIW
WIIIIIIIIIWWWIIIIIIIIIW
WIIIIIIIIIWWWIIIIIIIIIW
WIIIIIIIIIIIIIIIIIIIIIW
WIIIIIIIIIIIIIIIIIIIIIW
WIIIIIIIIIWWWIIIIIIIIIW
WIIIIIIIIIWWWIIIIIIIIIW
WIIIIIIIIIIIIIIIIIIIIIW
WIIIIIIIIIIIIIIIIIIIIIW
WWWWWWWWWWWWWWWWWWWWWWW
