WWWWWWWWWWWWWWWWWWWWWWW
WWFFFFFFFIIIIIFFFFFFFWW
WFWFFFFFFIIIIIFFFFFFWFW
WFFWFFFFFIIIIIFFFFFWFFW
WFFFFFFFFIIIIIFFFFFFFFW
WFFFFFFFFIIIIIFFFFFFFFW
WFFFFFFFFIIIIIFFFFFFFFW
WFFFFFFFFIIIIIFFFFFFFFW
WFFWFFFFFIIIIIFFFFFWFFW
WFWFFFFFFIIIIIFFFFFFWFW
WWFFFFFFFIIIIIFFFFFFFWW
WWWWWWWWWWWWWWWWWWWWWWW
