WWWWWWWWWWWWWWWWWWWWWWW
WIIIIIIIIIIIIIIIIIIIIIW
WIIIIIIIIIIIIIIIIIIIIIW
WIIIIIIIIIIIIIIIIIIIIIW
WIIIIIIIIIIWIIIIIIIIIIW
WIIIIIIIIIIWIIIIIIIIIIW
WIIIIIIWWWWWWWWWIIIIIIW
WIIIIIIIIIIWIIIIIIIIIIW
WIIIIIIIIIIWIIIIIIIIIIW
WIIIIIIIIIIIIIIIIIIIIIW
WIIIIIIIIIIIIIIIIIIIIIW
WWWWWWWWWWWWWWWWWWWWWWW
