WWWWWWWWWWWWWWWWWWWWWWW
WFFFFFHFFFFFWHFFFFFHFFW
WFFFFFHFFFFFWHFFFFFHFFW
WEFFFFHFFFFFWHFFFFFHEFW
WFFFFFHFFFFFWHFFFFFHFFW
WIIIIIIIIIIIIIIIIIIIIIW
WFFFFFFFFFFWFFFFFFFFFFW
WIIIIIIIIIIIIIIIIIIIIIW
WEFFFFHFFFFFWHFFFFFHEFW
WFFFFFHFFFFFWHFFFFFHFFW
WFFFFFHFFFFFWHFFFFFHFFW
WWWWWWWWWWWWWWWWWWWWWWW
