WWWWWWWWWWWWWWWWWWWWWWW
WIIIIIIIIIIIIIIIIIIIIIW
WIIIIIIIIIIIIIIIIIIIIIW
WIIIIIIIIIIIIIIIIIIIIIW
WIIIIIIIIIIHIIIIIIIIIIW
WIIIIIIIIIIHIIIIIIIIIIW
WIIIIIIHHHIIIHHHIIIIIIW
WIIIIIIIIIIHIIIIIIIIIIW
WIIIIIIIIIIHIIIIIIIIIIW
WIIIIIIIIIIIIIIIIIIIIIW
WIIIIIIIIIIIIIIIIIIIIIW
WWWWWWWWWWWWWWWWWWWWWWW
