WWWWWWWWWWWWWWWWWWWWWWW
WEFFFFFFFFFIFFFFFFFFFEW
WFFFFFFFFFFIFFFFFFFFFFW
WFFFFFFFFFFIFFFFFFFFFFW
WFFFFFFFFFFIFFFFFFFFFFW
WFFFFFFFFFFIFFFFFFFFFFW
WFFFFFFFFFFWFFFFFFFFFFW
WFFFFFFFFFFIFFFFFFFFFFW
WFFFFFFFFFFIFFFFFFFFFFW
WFFFFFFFFFFIFFFFFFFFFFW
WEFFFFFFFFFIFFFFFFFFFEW
WWWWWWWWWWWWWWWWWWWWWWW
