WWWWWWWWWWWWWWWWWWWWWWW
WFFFFFHFFFFFWHFFFFFHFFW
WFFFFFHFFFFFWHFFFFFHFFW
WFFFFFHFFFFFWHFFFFFHFFW
WFFFFFHFFFFFWHFFFFFHFFW
WIIIIIIIIIIIIIIIIIIIIIW
WFFFFFFFFFFWFFFFFFFFFFW
WIIIIIIIIIIIIIIIIIIIIIW
WFFFFFHFFFFFWHFFFFFHFFW
WFFFFFHFFFFFWHFFFFFHFFW
WFFFFFHFFFFFWHFFFFFHFFW
WWWWWWWWWWWWWWWWWWWWWWW
