WWWWWWWWWWWWWWWWWWWWWWW
WFFFFFFFFFFFFFFFFFFFFFW
WFFFFFFFFFFFFFFFFFFFFFW
WFFFFFFFFFHHHFFFFFFFFFW
WFFFFFFFFFHHHFFFFFFFFFW
WFFFFFFFFFHHHFFFFFFFFFW
WFFFFFFFFFFWFFFFFFFFFFW
WFFFFFFFFFHHHFFFFFFFFFW
WFFFFFFFFFHHHFFFFFFFFFW
WFFFFFFFFFHHHFFFFFFFFFW
WFFFFFFFFFFFFFFFFFFFFFW
WWWWWWWWWWWWWWWWWWWWWWW
