WWWWWWWWWWWWWWWWWWWWWWW
WFHIFHIFHIFHIFHIFHIFHFW
WHFIFHIFHIFHIFHIFHIFIFW
WFHIFHEFHIFHIFHEFHIFHFW
WHFIFHIFHIFHIFHIFHIFIFW
WFHIFHIFHIFHIFHIFHIFHFW
WFFFFFFFFFFWFFFFFFFFFFW
WHFIFHIFHIFHIFHIFHIFIFW
WFHIFHEFHIFHIFHEFHIFHFW
WHFIFHIFHIFHIFHIFHIFIFW
WFHIFHIFHIFHIFHIFHIFHFW
WWWWWWWWWWWWWWWWWWWWWWW
