WWWWWWWWWWWWWWWWWWWWWWW
WFFFFFFFFIFFFFFFFFFFFFW
WFFFFFFFFIFFFFFFFFFFFFW
WEFFFFFFFIFFFFFFFFFFEFW
WFFFFFFFFIFFFFFFFFFFFFW
WIIIIIIIIIIIIIIIIIIIIIW
WFFFFFFFFFFWFFFFFFFFFFW
WIIIIIIIIIIIIIIIIIIIIIW
WEFFFFFFFIFFFFFFFFFFEFW
WFFFFFFFFIFFFFFFFFFFFFW
WFFFFFFFFIFFFFFFFFFFFFW
WWWWWWWWWWWWWWWWWWWWWWW
