WWWWWWWWWWWWWWWWWWWWWWW
WFFFFFFFFFFFFFFFFFFFFFW
WFFFFFFFFFFFFFFFFFFFFFW
WFFFFFFFFFFFFFFFFFFFFFW
WFFFFFFFFFFHFFFFFFFFFFW
WFFFFFFFFFFHFFFFFFFFFFW
WFFFFFFHHHFFFHHHFFFFFFW
WFFFFFFFFFFHFFFFFFFFFFW
WFFFFFFFFFFHFFFFFFFFFFW
WFFFFFFFFFFFFFFFFFFFFFW
WFFFFFFFFFFFFFFFFFFFFFW
WWWWWWWWWWWWWWWWWWWWWWW
