WWWWWWWWWWWWWWWWWWWWWWW
WIIIIIIIIIIIIIIIIIIIIIW
WIIIIIIIIIIIIIIIIIIIIIW
WIIIIIIIIIIIIIIIIIIIIIW
WIIIIIIIIIIHIIIIIIIIIIW
WIIIIIIIIIIHIIIIIIIIIIW
WIIIIIIHHHFFFHHHIIIIIIW
WIIIIIIIIIIHIIIIIIIIIIW
WIIIIIIIIIIHIIIIIIIIIIW
WIIIIIIIIIIIIIIIIIIIIIW
WIIIIIIIIIIIIIIIIIIIIIW
WWWWWWWWWWWWWWWWWWWWWWW
