WWWWWWWWWWWWWWWWWWWWWWW
WFFFFFFFFFFFFFFFFFFFFFW
WFFFFFFFFFFFFFFFFFFFFFW
WFFFFFFFFIIIIIFFFFFFFFW
WFFFFFFFFFFIFFFFFFFFFFW
WFFFFFFFFFFIFFFFFFFFFFW
WFFFFFFFFFFLFFFFFFFFFFW
WFFFFFFFFFFIFFFFFFFFFFW
WFFFFFFFFFFIFFFFFFFFFFW
WFFFFFFFFIIIIIFFFFFFFFW
WFFFFFFFFFFFFFFFFFFFFFW
WWWWWWWWWWWWWWWWWWWWWWW
