WWWWWWWWWWWWWWWWWWWWWWW
WFFFFFFFFFFFFFFFFFFFFEFW
WFFFFFFFFFFFFFFFFFFFFFW
WFFFFFFFFFHHHFFFFFFFFFW
WFFFFFFFFFHHHFFFFFFFFFW
WEFFFFFFFFFHHHFFFFFFFFW
WFFFFFFFFFFWFFFFFFFFFFW
WFFFFFFFFFHHHFFFFFFFFEW
WFFFFFFFFFHHHFFFFFFFFFW
WFFFFFFFFFFFFFFFFFFFFFW
WEFFFFFFFFFFFFFFFFFFFFFEW
WWWWWWWWWWWWWWWWWWWWWWW
